SOXXXXXXXX
OOOXXXXXXX
OXOOOXOOOO
XXXXOXOXXO
OOOOOOOXXO
OXXOXXXXXO
OXXOXXEXXO
OXXOXOOXXO
OXXOOOXXXO
OOOOXXXXXX